################################
##............................##
#....>>..................>>....#
################################
#.......<<.....#......<<.......#
#..............#...............#
#..............#...............#
#..............#...............#
#.............###..............#
#............#####.............#
#...........#######............#
#..........#########...........#
#..........#########...........#
#..........#########...........#
#...........#######............#
#............#####.............#
#.............###..............#
#..............#...............#
#..............#...............#
#..............#...............#
#.....>>.......#.......>>......#
################################
#.......<<...........<<........#
#..............................#
#..............................#
##............................##
################################