################################
##............................##
#....()..................()....#
################################
#.......().....#......().......#
#..............#...............#
#..............#...............#
#..............#...............#
#.............###..............#
#............#####.............#
#...........#######............#
#..........#########...........#
#..........#########...........#
#..........#########...........#
#...........#######............#
#............#####.............#
#.............###..............#
#..............#...............#
#..............#...............#
#..............#...............#
#.....().......#.......()......#
################################
#.......()...........()........#
#..............................#
#..............................#
##............................##
################################