##############################################################################
#^....................++++++^.##########...........................#.........#
#................++++.........##########...........................#.........#
#.......++++++........##################.....................................#
##########..........####################.....................................#
##########.+......+.####################...........................#.........#
##########..+....+..####################...........................###########
##########.+......+.####################...........................#
##########+........+####################...........................#
#.........~~~~.#.........~......#......#...........................#
#.............#.#.......~..............#...........................#
#............#...#......~.....#........#...........................#
#...........#.....#.....~....#.........#...........................#
#..........#.......#....~...#..........#...........................#
###########.........#...~..#...~~~~~...#.......<<......<<..........#
#....................#....#............#######################.....#
#...................~.####....##########..>>.....#.....CC....#.....#
#...................~............................#...........#.....#
#...................~............................#...........#.....#
#.....................................<<.........#.....^^....#.....#
####################################################################
#.............................#....................................#
#..............................#...................................#
#...............................#..................................#
#................................#.................................#
#.................................#................................#
#..................................#...............................#
#...................................#####...................########
#........................................+..................########
#........................................~..................########
#........................................~..................########
#........................................+..................########
####################################################################