###############################
#.....H...............++++++*.#
#................++++.........#
#.*.....++++++........#########
###.............##............#
#.............................#
#...+#+#+#+#+#+#+#+#..........#
#.....................#.......#
#...............H.....#.......#
#####.....*............########
#........++++.....#...........#
#...#............#............#
#....############.......++++..#
#.........H.............+##+..#
#.#.................#...++++..#
#.....+++++++++.*.............#
#.....+#######+...............#
#.....+++++++++...............#
#................######.......#
#*..........................*.#
###############################