####################################################################
#................++++.........##########........................@))#
#.......++++++........##################.........................#.#
##########..........####################........................#^##
##########.+......+.####################...........................#
##########..+....+..####################...#########################
##########.+......+.####################..........................C#
##########+........+#########################################......#
#.........~~~~.#.........~......#......#........~..................#
#.............#.#.......~..............#........~..................#
#............#...#......~.....#........#........~..................#
#...........#.....#.....~....#.........#........~................#.#
#..........#.......#....~...#..........#.........~.............#..##
###########.........#...~..#...~~~~~...#.......>>.~....>>.....#....#
#....................#....#............#######################.....#
#...................~.####....##########..<<.....#.....CC...<#.....#
#...................~............................#...........#.....#
####################################################################
