##########################################
#.....................++++++*.############
#................++++.........############
#....H..++++++........####################
###.............##.......................
#..........H...............H.............
#...+#+#+#+#+#+#+#+#.....................
#.....................#.......############
#...........*.........#...*...############
#####*.................###################
#........++++.....#...........#
#...#............#............#
#....############.......++++..#
#.......................+##+*.#
#.#.................#...++++..#
#.....+++++++++...............#
#.....+#######+...............#
#.....+++++++++...............#
#................######.......#
#.............................#
########.............##########
########.............##########
########.............##########
########.............##########
########.............##########
########.....()......##########
###############################