##############################################################################
#^....................++++++^V##########...........................#.........#
#................++++.........##########...........................#.........#
#.......++++++........##################.........................#..........@#
##########..........####################........................#^#..........#
##########.+......+.####################...........................#.........#
##########..+....+..####################...###################################
##########.+......+.####################..........................C#
##########+........+#########################################......#
#.........~~~~.#.........~......#......#........~..................#
#.............#.#.......~..............#........~..................#
#............#...#......~.....#........#........~..................#
#...........#.....#.....~....#.........#........~................#.#
#..........#.......#....~...#..........#.........~.............#..##
###########.........#...~..#...~~~~~...#.......>>.~....>>.....#....#
#....................#....#............#######################.....#
#...................~.####....##########..<<.....#.....CC...<#.....#
#...................~............................#...........#.....#
#...................~............................#...........#.....#
#.....................................>>.........#.....^^....#..^..#
####################################################################
#..........<<.................#....................................#
#................#.............+...................................#
#..............####.............+..................................#
#.............######.............+.................................#
#.............######..............+................................#
#..............####................#...............................#
#................#..................################################
####################################################################