###############################
#.....................++++++..#
#................++++.........#
#.......++++++........#########
###.............##............#
#.............................#
#...+#+#+#+#+#+#+#+#..........#
#.....................#.......#
#.....................#.......#
#####..................########
#........++++.....#...........#
#...#............#............#
#....############.......++++..#
#.......................+##+..#
#.#.................#...++++..#
#.....+++++++++...............#
#.....+#######+...............#
#.....+++++++++...............#
#................######.......#
#.............................#
###############################