########################################
#^....................++++++^.##########
#................++++.........##########
#.......++++++........##################
##########..........####################
##########+........+####################
##########.+......+.####################
##########..+....+..####################
##########.+......+.####################
##########+........+####################
#.........~~~~.#.........~......#......#
#.............#.#.......~..............#
#............#...#......~.....#........#
#...........#.....#.....~....#.........#
#..........#.......#....~...#..........#
###########.........#...~..#...~~~~~...#
#....................#....#............#
#...................~.####....##########
#...................~..................#
#...................~..................#
#......................................#
########################################