###############################
#.....H...............++++++*.#
#................++++.........#
#.*.....++++++........#########
###.............##............#
#.............................#
#...+#+#+#+#+#+#+#+#..........#
#.............................#
#...............H.............#
#####.....*............########
#........++++.................#
#.............................#
#....############.......++++..#
#.........H.............+##+..#
#.#.................#...++++..#
#.....+++++++++.*.............#
#.....+#######+...............#
#.....+++++++++...............#
#................######.......#
#*..........................*.#
###############################