########################################
#^....................++++++^@##########
#................++++.........##########
#.......++++++........##################
########################################